1111111111111111
100011100P000001
1CCCC0C0000S0101
10E000000S00CC01
10000C000SS01001
1111111111111111
