11111111111111111111111
11111111111111111111111
11111111111111111111111
11111111S11111111111111
1E11111111111111111S111
111111111S111111P111111
11111111111111111111111
111111111r1111111111111
11111S11111111111111111
11111111111111111111111
11111111111111111111111
